111111111
1C0C0C0E1
10SSSSSS1
1C0CSC0C1
10S0S0S01
1CSC0CSC1
1SSSSSS01
1C0CSC0C1
10S0S0S01
1PSC0CSC1
111111111